XXXXXXXXXXXXXXXXXXXXXXXXXXXXXXXXXXXXXXXX
X__X_X__X_X__XX____X_______X_____X__X_XX
X__X_______X_X__X_XX___________________X
X______X______X__X_____XX_______X______X
X_______X_____X_XX__X_XX__________XX___X
X__X____X__X__X_____XX________X_X_X___XX
X_X___________XX____X_____X__X______X__X
XX________X__________X____X___X_______XX
X________XX___X_______X______X__XX_X__XX
X_____X____X___________XX_X__X_X____XX_X
XXX____________XX_________X_____X______X
X________X__________________X___X______X
X____X_________________________________X
X_X____XX______X_X_X_____X_X___________X
X__X_______X_____________________X____XX
X__X_X_____X____X___________X_X__X_____X
XX_X_X________X_______X__X__X____X____XX
X_______XX__X____X______X__________X___X
X_______X_____XX_X___X___X___XX___X_X__X
X_X____X_________X___X_X_X__________X__X
X___XXXX_X________X____XX__XXX__X_____XX
X____X__________X____X_X___X____X_XXX__X
X_X_X____X_X______________X____________X
XX_______X____X__________X_X_____X___X_X
X________X__X__X__X_X_______X_______X_XX
X______X_XX______X_X_X_____XX____X_____X
X__X______X___X__X__X________________X_X
XX__________X__________________X_____X_X
X____X_____X____X____________________X_X
X__________X_X__X__X__________X________X
X_______X___XXX__XX___XX___________X__XX
X_X___X__X_X______X__X____X_XX__XX_____X
X_______X_X___X___XX____X___X__________X
X________________X_X__X________________X
X______X__X___X__X_X_____X___X______XX_X
X__X_______X__X__X___X_____X___________X
X__XX__X________X___XX__X______X_______X
XX_________X________________X__________X
X____X___X______X_X_____X__________X___X
XXXXXXXXXXXXXXXXXXXXXXXXXXXXXXXXXXXXXXXX
