XXXXXXXXXXXXXXXXXXXX
X__X__X___________XX
X_____X__X_________X
X_XX_____X__X______X
X____________X_X___X
X__X_X_XX______X_X_X
X____________X_____X
XX_________X_X____XX
X__X_X_____________X
XX_X___XX____XX_X__X
XX________________XX
X__________________X
X_________XX_X____XX
X_______________X__X
XX_______________X_X
X_X_X__X__X________X
X_X__X____X________X
X________________X_X
X_______X_X_X______X
XXXXXXXXXXXXXXXXXXXX
